14
20
####################
#C............#...C#
#.#.####=##.#...##.#
#.....#---#...#....#
#.##.#############.#
#.#....#.........#.#
#...##. .##.##.#.#.#
#.#.############...#
#.#..............#.#
#.#.############.#.#
#.#..............#.#
#.################.#
#..................#
####################